pomodori
an interactive mystery by jd calvelli
Release 1 / Serial number 221003 / Inform 7 v10.1.2 / D

bedroom
You slowly open your eyes as the sun rises outside your window. Typical for you - it's always best to tend to your prized garden as early in the morning as possible! You aren't sure what is creaking more, the bed or your weary bones as you carefully, methodically extract yourself from your bed. Time to start another wonderful day.

You yawn and stretch, being extra careful not to sprain your back...again, and squint around at your familiar bedroom. Still the same old bed, dresser, and nightstand that you've had since the 50s. But you like it that way. It's cozy.

Your bathroom lies to your east, and the stairwell down to the rest of your home is to your north.

>e
You don't feel the need to go to the bathroom right now.

>examine shower
You see nothing special about the shower.

>x d
You see nothing unexpected in that direction.

>xj
That's not a verb I recognise.

>x john
You can't see any such thing.

>x dresser
You can't see any such thing.

>x bidet
You see nothing special about the bidet.

>x toilet
You see nothing special about the toilet.

>x sink
You see nothing special about the sink.

>x mirror
You see nothing special about the mirror.

>look
bathroom

>clear
What do you want to clear?

>l
bathroom

* * *

>e
You don't feel the need to go to the bathroom right now.

>n
You squint down the stairwell. Huh, was the bottom of the stairs always so fuzzy looking? Darn old age.

>test getoutofbedroom
(Testing.)

>[1] examine nightstand
Your nightstand. Pretty sure your mother's mother gave it to your mother, who gave it to you. Regardless, it's been in the family forever, but now it serves its spectacular purpose as a central location for your pair of glasses. So that you don't forget them, of course.

>[2] wear glasses
(first taking the pair of glasses)
The world comes into focus - no more squinting necessary. Ready to take on the day at full strength! Well, as full strength as you can muster at your age!

You put on the pair of glasses.

>[3] open dresser
You open the dresser, revealing a set of work clothes.

>[4] wear work clothes
(first taking the set of work clothes)
As you move to put on your clothes, you hear something jingling in the pockets of your cargo shorts. Oh boy, you left your keys in your pants again? Silly you!

You put on the set of work clothes.

>[5] take set of keys
Taken.

>[6] n
Isn't modern technology great! The glasses help you see to the bottom of the stairwell, so you start ambling down towards the bottom.

stairwell
You amble your way down the stairwell, and stop for a minute to catch your breath. You lean up against the banister and give your creaky knees a moment's respite. Good thing there are pictures to admire here while you rest.

>[7] n

entryway
The humble entryway of your quaint row house. To your right is the entryway closet, where things just always seem to end up when you forget where they are. Probably because it is closest to the door.

Your living room lies to your east, and your yard lies to your north.

>e
You can't go that way.

>e
You can't go that way.

>s
stairwell
You amble your way down the stairwell, and stop for a minute to catch your breath. You lean up against the banister and give your creaky knees a moment's respite. Good thing there are pictures to admire here while you rest.

>n
entryway
The humble entryway of your quaint row house. To your right is the entryway closet, where things just always seem to end up when you forget where they are. Probably because it is closest to the door.

Your living room lies to your east, and your yard lies to your north.

>n
yard
You step out into your yard, ready to bask in the glory of your wonderous garden. However, as you are taking your time down the cobblestone path, you can't help but shake the feeling that something isn't right. It feels as though something has changed, been disturbed.

The left planter is there, the right planter is there, your fence is still there, blocking your place of serenity from the hustle and bustle of the city beyond. But still...something seems wrong.

>s
entryway
The humble entryway of your quaint row house. To your right is the entryway closet, where things just always seem to end up when you forget where they are. Probably because it is closest to the door.

Your living room lies to your east, and your yard lies to your north.

>s
stairwell
You amble your way down the stairwell, and stop for a minute to catch your breath. You lean up against the banister and give your creaky knees a moment's respite. Good thing there are pictures to admire here while you rest.

>s
bedroom
You slowly open your eyes as the sun rises outside your window. Typical for you - it's always best to tend to your prized garden as early in the morning as possible! You aren't sure what is creaking more, the bed or your weary bones as you carefully, methodically extract yourself from your bed. Time to start another wonderful day.

You yawn and stretch, being extra careful not to sprain your back...again, and squint around at your familiar bedroom. Still the same old bed, dresser, and nightstand that you've had since the 50s. But you like it that way. It's cozy.

Your bathroom lies to your east, and the stairwell down to the rest of your home is to your north.

* * *

>e
You don't feel the need to go to the bathroom right now.

>w
bedroom

>n
stairwell

>n
entryway

>w
living room

>e
entryway

>n
yard

>n
You can't go that way.

>s
entryway

>n
yard

>w
You can't go that way.

>e
You can't go that way.

* * *

>enter bed
No time to sleep more, your garden is eagerly awaiting you, after all!

>examine dresser
test.

>open dresser
It isn't something you can open.

* * *

>examine dresser
Midcentury modern, just like the rest of your furniture. Well, now it's called midcentury modern, apparently. When you got it it was just modern! It's currently closed.

>enter bed
No time to sleep more, your garden is eagerly awaiting you, after all!

>enter bed
No time to sleep more, your garden is eagerly awaiting you, after all!

>examine dresser
test

* * *

>examine dresser
Midcentury modern, just like the rest of your furniture. Well, now it's called midcentury modern, apparently. When you got it it was just modern! It's currently closed.

>open dresser
You open the dresser, revealing a set of work clothes.

>examine dresser
Midcentury modern, just like the rest of your furniture. Well, now it's called midcentury modern, apparently. When you got it it was just modern! It's currently open.

* * *

>open dresser
You open the dresser, revealing a set of work clothes.

>examine work clothes
Green cargo shorts and a matching collared shirt. Both are wrinkled from frequent use. No iron could ever press out the years of gardening that they've seen.

>take work clothes
Taken.

>wear work clothes
As you carefully put on your clothes, you hear something jingling in the pockets of your cargo shorts. Oh boy, you left your keys in your pants again? Silly you!

You put on the set of work clothes.

* * *

>examine window
Through the window you see the shining sun. A bright and cheery day. You feel incredible just thinking about it. No better day than today to garden.

* * *

>get in bed
No time to sleep more, your garden is eagerly awaiting you, after all!

>examine dresser
The dresser is empty.

* * *

>go to dresser
You can't see any such thing.

>examine dresser
Midcentury modern, just like the rest of your furniture. Well, now it's called midcentury modern, apparently. When you got it it was just modern! It's currently closed.

* * *

>take work clothes
Taken.

>wear work clothes
You put on the set of work clothes.

>inventory
You are carrying:
  a set of work clothes (being worn)

* * *

>look at window
You see nothing special about the window.

>examine window
You see nothing special about the window.

* * *

>magnify dresser
You need a tool with which to magnify things...

>test getoutofbedroom
(Testing.)

>[1] examine nightstand
Your nightstand. Pretty sure your mother's mother gave it to your mother, who gave it to you. Regardless, it's been in the family forever, but now it serves its spectacular purpose as a central location for your pair of glasses. So that you don't forget them, of course.

>[2] wear glasses
(first taking the pair of glasses)
The world comes into focus - no more squinting necessary. Ready to take on the day at full strength! Well, as full strength as you can muster at your age!

You put on the pair of glasses.

>[3] open dresser
You open the dresser, revealing a set of work clothes.

>[4] wear work clothes
(first taking the set of work clothes)
As you move to put on your clothes, you hear something jingling in the pockets of your cargo shorts. Oh boy, you left your keys in your pants again? Silly you!

You put on the set of work clothes.

>[5] take set of keys
Taken.

>[6] n
Isn't modern technology great! The glasses help you see to the bottom of the stairwell, so you start ambling down towards the bottom.

stairwell
You amble your way down the stairwell, and stop for a minute to catch your breath. You lean up against the banister and give your creaky knees a moment's respite. Good thing there are pictures to admire here while you rest.

>[7] n
Isn't modern technology great! The glasses help you see to the bottom of the stairwell, so you start ambling down towards the bottom.

entryway
The humble entryway of your quaint row house. To your right is the entryway closet, where things just always seem to end up when you forget where they are. Probably because it is closest to the door.

Your living room lies to your east, and your yard lies to your north.

>n
Isn't modern technology great! The glasses help you see to the bottom of the stairwell, so you start ambling down towards the bottom.

yard
You step out into your yard, ready to bask in the glory of your wonderous garden. However, as you are taking your time down the cobblestone path, you can't help but shake the feeling that something isn't right. It feels as though something has changed, been disturbed.

The left planter is there, the right planter is there, your fence is still there, blocking your place of serenity from the hustle and bustle of the city beyond. But still...something seems wrong.

>s
entryway
The humble entryway of your quaint row house. To your right is the entryway closet, where things just always seem to end up when you forget where they are. Probably because it is closest to the door.

Your living room lies to your east, and your yard lies to your north.

>open closet
You open the closet, revealing a shiny red toolbox.

>unlock toolbox
What do you want to unlock the shiny red toolbox with?

>keys
You unlock the shiny red toolbox.

>examine toolbox
A polished, well maintained toolbox. An essential element in the arsenal of a master gardener. The toolbox is closed.

>open toolbox
You open the shiny red toolbox, revealing a spade, a bag of seeds and a magnifying glass.

>examine toolbox
A polished, well maintained toolbox. An essential element in the arsenal of a master gardener. Inside the open toolbox you can see the core elements of any gardener's kit, a spade and a bag of seeds. There is also a special tool for which you've found most use in your aging years - a magnifying glass.

In the shiny red toolbox are a spade, a bag of seeds and a magnifying glass.

>take magnifying glass
Taken.

>magnify bag of seeds
On close inspection, nothing looks out of the ordinary...

>n
Isn't modern technology great! The glasses help you see to the bottom of the stairwell, so you start ambling down towards the bottom.

yard
You step out into your yard, ready to bask in the glory of your wonderous garden. However, as you are taking your time down the cobblestone path, you can't help but shake the feeling that something isn't right. It feels as though something has changed, been disturbed.

The left planter is there, the right planter is there, your fence is still there, blocking your place of serenity from the hustle and bustle of the city beyond. But still...something seems wrong.

>magnify tomatoes
Using the magnifying glass, you can see what look like two semicircular rings of small holes on many of the ruined tomatoes. Bite marks! But of what? One step closer to justice...

* * *

>n
You squint down the stairwell. Huh, was the bottom of the stairs always so fuzzy looking? Darn old age.

>e
You don't feel the need to go to the bathroom right now.

>look
bedroom
You make your way back into your bedroom. Thankfully, your bed, dresser, and nightstand are still there. Nothing got up and ran away while you were gone!

Your bathroom lies to your east, and the stairwell down to the rest of your home is to your north.

* * *

>n
You squint down the stairwell. Huh, was the bottom of the stairs always so fuzzy looking? Darn old age.

>examine nightstand
Your nightstand. Pretty sure your mother's mother gave it to your mother, who gave it to you. Regardless, it's been in the family forever, but now it serves its spectacular purpose as a central location for your pair of glasses. So that you don't forget them, of course.

>take pair of glasses
Taken.

>wear glasses
The world comes into focus -no more squinting necessary. Ready to take on the day at full strength! Well, as full strength as you can muster at your age!

You put on the pair of glasses.

>n
Isn't modern technology great! The glasses help you see to the bottom of the stairwell, so you start ambling down towards the bottom.

* * *

>take pair of glasses
Taken.

>wear pair of glasses
The world comes into focus - no more squinting necessary. Ready to take on the day at full strength! Well, as full strength as you can muster at your age!

You put on the pair of glasses.

>n
Isn't modern technology great! The glasses help you see to the bottom of the stairwell, so you start ambling down towards the bottom.

stairwell

* * *

>n
You squint down the stairwell. Huh, was the bottom of the stairs always so fuzzy looking? Darn old age.

>test getoutofbedroom
(Testing.)

>[1] examine nightstand
Your nightstand. Pretty sure your mother's mother gave it to your mother, who gave it to you. Regardless, it's been in the family forever, but now it serves its spectacular purpose as a central location for your pair of glasses. So that you don't forget them, of course.

>[2] wear glasses
(first taking the pair of glasses)
The world comes into focus - no more squinting necessary. Ready to take on the day at full strength! Well, as full strength as you can muster at your age!

You put on the pair of glasses.

>[3] open dresser
You open the dresser, revealing a set of work clothes.

>[4] wear work clothes
(first taking the set of work clothes)
As you move to put on your clothes, you hear something jingling in the pockets of your cargo shorts. Oh boy, you left your keys in your pants again? Silly you!

You put on the set of work clothes.

>[5] take set of keys
Taken.

>[6] n
Isn't modern technology great! The glasses help you see to the bottom of the stairwell, so you start ambling down towards the bottom.

stairwell
You amble your way down the stairwell, and stop for a minute to catch your breath. You lean up against the banister and give your creaky knees a moment's respite. Good thing there are pictures to admire here while you rest.

>[7] n

entryway
The humble entryway of your quaint row house. To your right is the entryway closet, where things just always seem to end up when you forget where they are. Probably because it is closest to the door.

Your living room lies to your west, and your yard lies to your north.

>s
stairwell
You amble your way down the stairwell, and stop for a minute to catch your breath. You lean up against the banister and give your creaky knees a moment's respite. Good thing there are pictures to admire here while you rest.

>n
entryway
The humble entryway of your quaint row house. To your right is the entryway closet, where things just always seem to end up when you forget where they are. Probably because it is closest to the door.

Your living room lies to your west, and your yard lies to your north.

>s
stairwell
You amble your way down the stairwell, and stop for a minute to catch your breath. You lean up against the banister and give your creaky knees a moment's respite. Good thing there are pictures to admire here while you rest.

>s
bedroom
Back in your bedroom.

Your bathroom lies to your east, and the stairwell down to the rest of your home is to your north.

* * *

>n
You squint down the stairwell. Huh, was the bottom of the stairs always so fuzzy looking? Darn old age.

>x pictures
You see nothing special about the pictures.

>x banister
You see nothing special about the banister.

* * *

>open chest
It seems to be locked.

* * *

>open dresser
You open the dresser, revealing a set of work clothes.

>take work clothes
Taken.

>wear work clothes
As you move to put on your clothes, you hear something jingling in the pockets of your cargo shorts. Oh boy, you left your keys in your pants again? Silly you!

You put on the set of work clothes.

>take keys
Taken.

>open chest
It seems to be locked.

>unlock chest
What do you want to unlock the chest with?

>keys
You unlock the chest.

* * *

>take keys
Taken.

>take keyring
Taken.

>inventory
You are carrying:
  a keyring
  a set of work clothes (being worn)

* * *

>open dresser
You open the dresser, revealing a set of work clothes.

>wear work clothes
(first taking the set of work clothes)
As you move to put on your clothes, you hear something jingling in the pockets of your cargo shorts. Oh boy, you left your keys in your pants again? Silly you!

You put on the set of work clothes.

>take keys
Taken.

>examine nightstand
Your nightstand. Pretty sure your mother's mother gave it to your mother, who gave it to you. Regardless, it's been in the family forever, but now it serves its spectacular purpose as a central location for your pair of glasses. So that you don't forget them, of course.

>wear glasses
(first taking the pair of glasses)
The world comes into focus - no more squinting necessary. Ready to take on the day at full strength! Well, as full strength as you can muster at your age!

You put on the pair of glasses.

>n
Isn't modern technology great! The glasses help you see to the bottom of the stairwell, so you start ambling down towards the bottom.

stairwell
You amble your way on the stairwell, and stop for a minute to catch your breath. You lean up against the banister and give your creaky knees a moment's respite. Good thing there are pictures to admire here while you rest.

>s
bedroom
Once again in your bedroom. Thankfully, your bed, dresser, and nightstand are still there. Nothing got up and ran away while you were gone!

Your bathroom lies to your east, and the stairwell down to the rest of your home is to your north.

>n
Isn't modern technology great! The glasses help you see to the bottom of the stairwell, so you start ambling down towards the bottom.

stairwell
You amble your way on the stairwell, and stop for a minute to catch your breath. You lean up against the banister and give your creaky knees a moment's respite. Good thing there are pictures to admire here while you rest.

>n
entryway
The humble entryway of your quaint row house. To your right is the entryway closet, where things just always seem to end up when you forget where they are. Probably because it is closest to the door.

Your living room lies to your west, and your yard lies to your north.

>e
You can't go that way.

>w
living room
You're cozy living room. It follows the same general decor of the rest of your home; some might call it old, others might call it retro. It's okay, it's enough for you. A simple couch and coffee table - on which your gardening books are sprawled across, a television - for which you don't often find much use, and the north and south windows which frame the space. Tucked in the corner of the space is a small kitchen alcove.

Your entryway lies to your east.

>examine coffee table
A classic example of function over form - it's probably the most nondescript piece of furniture you own. Definitely is, compared to the antiques you have around, actually. But, it's necessary as the perfect reading station for your gardening books! You have many lying around, but three here catch your eye -

"Tomato Tips" by Camron Gonzalez, "Planter Aesthetics" by Jet Vellinga, and "Pesky Pests" by Priscilla Xu.

* * *

>read bathroom
You can't see any such thing.

>read dresser
test

* * *

>s
You can't go that way.

>n
stairwell

>n
entryway
You can see a closet (closed) here.

>n
yard
You can see a left planter (on which is a ruined tomatoes) and a right planter (on which is a basil) here.

* * *

>take glasses
Taken.

>wear glasses
You put on the glasses.

* * *

>take window
That's hardly portable.

>unlock chest
(with the window)
(first taking the window)
That's hardly portable.

* * *

>test
>--> The following tests are available:
'test getoutofbedroom'

>test getoutofbedroom
(Testing.)

>[1] examine nightstand
Your nightstand. Pretty sure your mother's mother gave it to your mother, who gave it to you. Regardless, it's been in the family forever, but now it serves its spectacular purpose as a central location for your pair of glasses. So that you don't forget them, of course.

>[2] wear glasses
(first taking the pair of glasses)
The world comes into focus - no more squinting necessary. Ready to take on the day at full strength! Well, as full strength as you can muster at your age!

You put on the pair of glasses.

>[3] n
Isn't modern technology great! The glasses help you see to the bottom of the stairwell, so you start ambling down towards the bottom.

stairwell
You amble your way down the stairwell, and stop for a minute to catch your breath. You lean up against the banister and give your creaky knees a moment's respite. Good thing there are pictures to admire here while you rest.

>examine banister
Taking a quick glance over the banister, you can see your living room down below. It's your second favorite place to be, after your garden, naturally. I mean, where else would you read your gardening books?

>examine pictures
It's always lovely to take a walk down memory lane. You've made a point to take pictures of every moment in your gardening experience that you've been proud of. There have been so many!

That one there? Oh, that is when you won the county fair for your largest cucumber!

This one? Oh, that was from when you made jack-o-lanterns during Halloween-time with the pumpkins you grew yourself.

Good times all around.

* * *

>test getoutofbedroom
(Testing.)

>[1] examine nightstand
Your nightstand. Pretty sure your mother's mother gave it to your mother, who gave it to you. Regardless, it's been in the family forever, but now it serves its spectacular purpose as a central location for your pair of glasses. So that you don't forget them, of course.

>[2] wear glasses
(first taking the pair of glasses)
The world comes into focus - no more squinting necessary. Ready to take on the day at full strength! Well, as full strength as you can muster at your age!

You put on the pair of glasses.

>[3] open dresser
You open the dresser, revealing a set of work clothes.

>[4] wear work clothes
(first taking the set of work clothes)
As you move to put on your clothes, you hear something jingling in the pockets of your cargo shorts. Oh boy, you left your keys in your pants again? Silly you!

You put on the set of work clothes.

>[5] take set of keys
Taken.

>[6] n
Isn't modern technology great! The glasses help you see to the bottom of the stairwell, so you start ambling down towards the bottom.

stairwell
You amble your way on the stairwell, and stop for a minute to catch your breath. You lean up against the banister and give your creaky knees a moment's respite. Good thing there are pictures to admire here while you rest.

>[7] n

entryway
The humble entryway of your quaint row house. To your right is the entryway closet, where things just always seem to end up when you forget where they are. Probably because it is closest to the door.

Your living room lies to your west, and your yard lies to your north.

>e
You can't go that way.

* * *

>w
living room
You're cozy living room. It follows the same general decor of the rest of your home; some might call it old, others might call it retro. It's okay, it's enough for you. A simple couch and coffee table - on which your gardening books are sprawled across, a television - for which you don't often find much use, and the north and south windows which frame the space. Tucked in the corner of the space is a small kitchen alcove.

Your entryway lies to your east.

>examine coffee table
A classic example of function over form - it's probably the most nondescript piece of furniture you own. Definitely is, compared to the antiques you have around, actually. But, it's necessary as the perfect reading station for your gardening books! You have many lying around, but three here catch your eye - "Tomato Tips" by Camron Gonzalez, "Planter Aesthetics" by Jet Vellinga, and "Pesky Pests" by Priscilla Xu.

>examine tomato tips
The cover of the work depicts a lovely cartoon tomato. Something to aspire towards in your own garden.

>read tomato tips
The cover of the work depicts a lovely cartoon tomato. Something to aspire towards in your own garden.

* * *

>n
Isn't modern technology great! The glasses help you see to the bottom of the stairwell, so you start ambling down towards the bottom.

yard
You step out into your yard, ready to bask in the glory of your wonderous garden. However, as you are taking your time down the cobblestone path, you can't help but shake the feeling that something isn't right. It feels as though something has changed, been disturbed.

The left planter is there, the right planter is there, your fence is still there, blocking your place of serenity from the hustle and bustle of the city beyond. But still...something seems wrong.

You can see a left planter and a right planter (on which is a basil) here.

>examine left planter
Oh no...

Oh, the horror...

You're tomatoes...they're...

They're ruined.

The scene of the crime is grizzly. Tomatoes scattered and torn off of their stems, squashed and leaking their delicious innards...You have to look away, it's too graphic.

You must find out who did this to your lovelies. There must be justice.

>examine tomatoes
It breaks your heart to see your lovely tomatoes in such a state. As much as it pains you, you know that you need to be there for them in this moment. You need to learn more to bring the culprit to justice.

* * *

>examine left planter
Oh no...

Oh, the horror...

You're tomatoes...they're...

They're ruined.

The scene of the crime is grizzly. Tomatoes scattered and torn off of their stems, squashed and leaking their delicious innards...You have to look away, it's too graphic.

You must find out who did this to your lovelies. There must be justice.

>take tomatoes
Taken.

>examine tomatoes
 You cradle the ruined tomatoes in your arms to spend one last moment with them. At this distance, you can notice that there are some small markings on some of the tomatoes, but your eyes aren't what they used to be. If only you could get even closer...

* * *

>open closet
You open the closet, revealing nothing.

>examine closit
You can't see any such thing.

>closet
That's not a verb I recognise.

>examine closet
A simple, accordion folding wooden closet. The closet is folded away, revealing a mish-mash of various items you can't really make heads or tails of. However, stacked neatly on top of the chaos is shiny red toolbox.

>examine toolbox
A polished, well maintained toolbox. An essential element in the arsenal of a master gardener. It seems locked shut. Now where did I put my darn keys...

>unlock toolbox with keys
You unlock the shiny red toolbox.

>examine toolbox
A polished, well maintained toolbox. An essential element in the arsenal of a master gardener. It seems locked shut. Now where did I put my darn keys...

>open toolbox
You open the shiny red toolbox.

>examine toolbox
A polished, well maintained toolbox. An essential element in the arsenal of a master gardener. Inside you can see the core elements of any gardener's kit, a spade and a bag of seeds. There is also a special tool for which you've found most use in your aging years - a magnifying glass.

* * *

>open closet
You open the closet, revealing a shiny red toolbox.

>examine closet
A simple, accordion folding wooden closet. The closet is folded away, revealing a mish-mash of various items you can't really make heads or tails of. However, perched precariously on top of the chaos is shiny red toolbox.

In the closet is a shiny red toolbox.

>examine toolbox
A polished, well maintained toolbox. An essential element in the arsenal of a master gardener. It seems locked shut. Now where did I put my darn keys...

>unlock toolbox
What do you want to unlock the shiny red toolbox with?

* * *

>keys
You unlock the shiny red toolbox.

>open toolbox
You open the shiny red toolbox, revealing a spade, a bag of seeds and a magnifying glass.

* * *

>take magnifying glass
Taken.

>use magnifying glass on spade
On close inspection, nothing looks out of the ordinary...

* * *

>examine closet
A simple, accordion folding wooden closet. The closet is folded away, revealing a mish-mash of various items you can't really make heads or tails of. However, perched precariously on top of the chaos is shiny red toolbox.

In the closet is a shiny red toolbox.

>open toolbox
It seems to be locked.

>examine toolbox
A polished, well maintained toolbox. An essential element in the arsenal of a master gardener. It seems locked shut. Now where did I put my darn keys...

* * *

>examine toolbox
A polished, well maintained toolbox. An essential element in the arsenal of a master gardener. The toolbox is closed.

>open toolbox
You open the shiny red toolbox.

>examine toolbox
A polished, well maintained toolbox. An essential element in the arsenal of a master gardener. Inside the open toolbox you can see the core elements of any gardener's kit, a spade and a bag of seeds. There is also a special tool for which you've found most use in your aging years - a magnifying glass.

* * *

>keys
You unlock the shiny red toolbox.

>take magnifying glass
You can't see any such thing.

>examine toolbox
A polished, well maintained toolbox. An essential element in the arsenal of a master gardener. The toolbox is closed.

* * *

>open toolbox
You open the shiny red toolbox, revealing a spade, a bag of seeds and a magnifying glass.

>take magnifying glass
Taken.

>n
yard
You step out into your yard, ready to bask in the glory of your wonderous garden. However, as you are taking your time down the cobblestone path, you can't help but shake the feeling that something isn't right. It feels as though something has changed, been disturbed.

The left planter is there, the right planter is there, your fence is still there, blocking your place of serenity from the hustle and bustle of the city beyond. But still...something seems wrong.

>examine planter
Which do you mean, the left planter or the right planter?

>left
Oh no...

Oh, the horror...

You're tomatoes...they're...

They're ruined.

The scene of the crime is grizzly. Tomatoes scattered and torn off of their stems, squashed and leaking their delicious innards...You have to look away, it's too graphic.

You must find out who did this to your lovelies. There must be justice.

>take tomatoes
Taken.

>magnify tomatoes
Using the magnifying glass, you can see what look like two semicircular rings of small holes on many of the ruined tomatoes. Bite marks! But of what? One step closer to justice...

>s
entryway
The humble entryway of your quaint row house. To your right is the entryway closet, where things just always seem to end up when you forget where they are. Probably because it is closest to the door.

Your living room lies to your west, and your yard lies to your north.

>w
living room
You're cozy living room. It follows the same general decor of the rest of your home; some might call it old, others might call it retro. It's okay, it's enough for you. A simple couch and coffee table - on which your gardening books are sprawled across, a television - for which you don't often find much use, and the north and south windows which frame the space. Tucked in the corner of the space is a small kitchen alcove.

Your entryway lies to your east.

* * *

>examine coffee table
A classic example of function over form - it's probably the most nondescript piece of furniture you own. Definitely is, compared to the antiques you have around, actually. But, it's necessary as the perfect reading station for your gardening books! You have many lying around, but three here catch your eye - "Tomato Tips" by Camron Gonzalez, "Planter Aesthetics" by Jet Vellinga, and "Pesky Pests" by Priscilla Xu.

>read pesky pests
You flip through all the pages to see if you can find a matching bite mark to that seen on your poor tomatoes. Suddenly - there it is, clear as day! The bite marks match almost exactly to...

Those of a racoon! It seems you've found your culprit!

Mystery solved! You put on your jacket and head out into the city to find some non-harmful racoon traps to ensure the safety of your precious tomatoes going forward.
Thank you so much for playing!

    *** The End ***

Would you like to RESTART, RESTORE a saved game, QUIT or UNDO the last command?

* * *

>w
living room
You're cozy living room. It follows the same general decor of the rest of your home; some might call it old, others might call it retro. It's okay, it's enough for you. A simple couch and coffee table - on which your gardening books are sprawled across, a television - for which you don't often find much use, and the north and south windows which frame the space. Tucked in the corner of the space is a small kitchen alcove.

Your entryway lies to your east.

>read kitchen
not readable.

>examine coffee table
A classic example of function over form - it's probably the most nondescript piece of furniture you own. Definitely is, compared to the antiques you have around, actually. But, it's necessary as the perfect reading station for your gardening books! You have many lying around, but three here catch your eye - "Tomato Tips" by Camron Gonzalez, "Planter Aesthetics" by Jet Vellinga, and "Pesky Pests" by Priscilla Xu.

>read tomato tips
test 1.

>read planter aesthetics
test 2.

>read pesky pests
test 3.

* * *

>w
living room
You're cozy living room. It follows the same general decor of the rest of your home; some might call it old, others might call it retro. It's okay, it's enough for you. A simple couch and coffee table - on which your gardening books are sprawled across, a television - for which you don't often find much use, and the north and south windows which frame the space. Tucked in the corner of the space is a small kitchen alcove.

Your entryway lies to your east.

>sit couch
I didn't understand that sentence.

>sit on couch
You just woke up, lazybones! No reason to take a break now!

>switch on television
You'd rather not watch television right now. There's nothing good on cable these days anyway.

>watch television
You don't believe you've gotten a new television for a while. Your children tell you often that there are these new ways to watch television? Net-something? Well, whatever it is, your television can't do it. What do you need that for anyway? You barely use this thing anyway.

The television is currently switched off.

* * *

>y
That was a rhetorical question.

>n
Isn't modern technology great! The glasses help you see to the bottom of the stairwell, so you start ambling down towards the bottom.

yard
You step out into your yard, ready to bask in the glory of your wonderous garden. However, as you are taking your time down the cobblestone path, you can't help but shake the feeling that something isn't right. It feels as though something has changed, been disturbed.

The left planter is there, the right planter is there, your fence is still there, blocking your place of serenity from the hustle and bustle of the city beyond. But still...something seems wrong.

>take tomatoes
Taken.

>take basil
Taken.

>eat tomatoes
You stop yourself before you continue. As tasty as you are sure they are, even in their sad state, you know that you can't be rid of the only evidence you have. Justice comes first. Hunger can come later.

>eat basil
Just one taste couldn't hurt...right?
You devour the entire plant. The taste is just so divine. What a shame, now you know for sure that the plant would have won first place at the county fair...

That's plainly inedible.

* * *

>unlock chest
What do you want to unlock the chest with?

>dresser
(first taking the dresser)
That's fixed in place.

>examine window
Through the window you see the shining sun. A bright and cheery day. You feel incredible just thinking about it. No better day than today to garden.

* * *

>dresser
(first taking the dresser)
That's fixed in place.

>inventory
You are carrying:
  a dresser (closed)

* * *

>unlock chest
What do you want to unlock the chest with?

>examine chest
Its a dusty old chest, you think you keep some things in there, but you honestly can't even remember. It's been so long since you've opened it. But it looks nice! So you keep it around for the aesthetic.

* * *

>unlock chest
What do you want to unlock the chest with?

>open dresser
You open the dresser, revealing a set of work clothes.

* * *

>unlock chest
What do you want to unlock the chest with?

>unlock chest
(with the window)
(first taking the window)
That's hardly portable.

>open dresser
You open the dresser, revealing a set of work clothes.